Hindi: नमस्ते
Bengali: হ্যালো
Telugu: హలో
Marathi: हॅलो
Tamil: வணக்கம்
Urdu: ہیلو
Gujarati: નમ્ર
Kannada: ನಮಸ್ಕಾರ
Odia: ନମସ୍କାର
Malayalam: ഹലോ
Punjabi: ਸਤ ਸ੍ਰੀ ਅਕਾਲ
Nepali: अभिवादन
English: hello
Spanish: Hola
Arabic: مرحبًا
French: Bonjour
Russian: привет
Chinese: 你好
Portuguese: olá
German: Hallo
Japanese: こんにちは
Korean: 안녕하세요
Italian: Ciao
Dutch: Hallo
Turkish: Merhaba
Thai: สวัสดี
Vietnamese: Xin chào
Swedish: Hej
Polish: Witam
Indonesian: Hallo
Greek: Γειά σου
Czech: Ahoj
Hungarian: Helló
Finnish: Hei
Norwegian: Hallo
Danish: HejSlovak: AhojRomanian: Buna ziua
